20, 15
11111111111111111111
12000000000011111111
11111111111011111111
11111111111011111111
11111111111011111111
11111111111011111111
11111111111011111111
11111111111011111111
11111111111011111111
11111111111011111111
11111111111011111111
11111111111011111111
11111111111011111111
11111111111000000031
11111111111111111111