20, 15
11111111111111111111
12000040000411111111
11111111111011111111
11111111111011111111
11111111111411111111
11111111111011111111
11111111111511111111
11111111111011111111
11111111111611111111
11110000400011111111
11110111111411111111
11110111111011111111
11110111111011111111
11110004000504006031
11111111111111111111