20, 15
11111111111111111111
12000040000411111111
11111111111011111111
11111111111011111111
11111111111411111111
11111111111011111111
11111111111011111111
11111111111011111111
11111111111011111111
11111111111011111111
11111111111411111111
11111111111011111111
11111111111011111111
11111111111004000031
11111111111111111111