20, 15
11111111111111111111
12000000000000001111
11111110111111100011
11111110111111111001
11100000000000111011
10001111111110111011
10111111111110000001
10000001111111111101
11111101110000111101
10011101110110000001
11000001110111111111
10011111110000001111
10111110011111101111
10000000111111100031
11111111111111111111