20, 15
11111111111111111111
12000000000000000031
11040040004004004011
11111114111111101001
11100400505040100411
14001110000610111011
16111000111110604001
10004050111111111101
11111106114006111141
16011141110114000001
11004001110001111111
10011116110504001111
14111110411111051111
16004400111111040031
11111111111111111111